XXXXXXXXXXXXXXX
X           XPX
XXXXX       X X
XS  X       X X
X           X X
X   X       X X
X   X         X
XXXXX       X X
X           X X
XXDXXXXXXXXXXXX