XXXXXXXXXXXXXXXXXXXXXXXXXXXXXX
X P           X    S  X      X
XXX           X       X      X
XXX           X XXXXXXX      X
XXX S                    T   D
XXXXXXXXXXXXXXXXXXXXXXXXXXXXXX