XXXXXXXDXXXXXXX
X     X X     X
X     X X     X
X     X X     X
X             X
X             X
X             X
X             X
X  P          X
XXXXXXXXXXXXXXX