XXXXXXXXXXXXXXXXXXXXXXXXXXXXXX
X P                S  X      X
XXX                   X      X
XXX           XXXXXXXXX      X
XXX S                    T   D
XXXXXXXXXXXXXXXXXXXXXXXXXXXXXX