XXXXXXXXXX
X        D
X     T  X
X        X
X        X
X        X
X        X
X        X
X  P     X
XXXXXXXXXX