XXXXXXXXXXXXXXX
XP  X        TX
X   X X       X
X   X XXXXX   X
X   X X       X
X   X X      TX
X     X       X
XXXXXXXXXXXXXDX