XXXXXXXXXX
X  P  X OX
X     X  X
XX       X
X        X
X   XX   X
X   X    X
X   X    X
X        X
XXXXX  F X
XXXXXXXXXX